|-----------------|
|                 |
|      ===        |
|    ==+++==      |
|   =+++++++=     |
|  ======+++=     |
|  =#####=+++=    |
| =#######=++===  |
| =#######=++=++= |
|  =#####=+++=++= |
|  ======++++=++= |
|  =+++++++++=++= |
|  =+++++++++=++= |
|  =+++++++++===  |
|  =++====+++=    |
|  =++=   =++=    |
|   ==     ==     |
|                 |
|                 |
|                 |
|                 |
|                 |
|                 |
|                 |
|                 |
|-----------------|
