|------------------------|
|                        |
|      #####++#####      |
|   ###====#++#====###   |
|  #=======#++#=======#  |
|  #======@++++@======#  |
|  +++++++++@@+++++++++  |
|  +++++++++@@+++++++++  |
|  +++@@@@++++++@@@@+++  |
|    +@@@@@++++@@@@@+    |
|    ++@@@@++++@@@@++    |
|      ++++++++++++      |
|                        |
|                        |
|                        |
|                        |
|                        |
|                        |
|                        |
|                        |
|                        |
|                        |
|                        |
|                        |
|                        |
|                        |
|                        |
|------------------------|