|-----------------|
|                 |
|        +        |
|       +=+       |
|        +        |
|                 |
|                 |
|                 |
|                 |
|                 |
|                 |
|                 |
|                 |
|                 |
|-----------------|
