................
................
.##############.
.==============.
.--------------.