................
................
.@.+.+.+.+.+.+@.
.@+.+.+.+.+.+.@.
.@.+.+.+.+.+.+@.
.@+.+.+.+.+.+.@.
.@.+.+.+.+.+.+@.
.@+.+.+.+.+.+.@.
.@.+.+.+.+.+.+@.
.@+.+.+.+.+.+.@.
.@.+.+.+.+.+.+@.
.@+.+.+.+.+.+.@.
.@.+.+.+.+.+.+@.
.@@@@@@@@@@@@@@.