|----------------|
|                |
|                |
| @ + + + + + +@ |
| @+ + + + + + @ |
| @ + + + + + +@ |
| @+ + + + + + @ |
| @ + + + + + +@ |
| @+ + + + + + @ |
| @ + + + + + +@ |
| @+ + + + + + @ |
| @ + + + + + +@ |
| @+ + + + + + @ |
| @ + + + + + +@ |
| @@@@@@@@@@@@@@ |
|                |
|                |
|                |
|                |
|                |
|----------------|