................
................
.##############.
.==============.
.++++++++++++++.