|----------------|
|                |
| ++++++++++++++ |
| ++=++++++++=++ |
| +=#=++++++=#=+ |
| ++=+++==+++=++ |
| +++++=##=+++++ |
| ++=+++==+++=++ |
| +=#=++++++=#=+ |
| ++=++++++++=++ |
| ++++++++++++++ |
|                |
|                |
|                |
|                |
|                |
|                |
|                |
|                |
|                |
|                |
|                |
|                |
|                |
|----------------|
