|----------------|
|                |
| ############## |
| ============== |
| ++++++++++++++ |
|                |
|                |
|                |
|                |
|                |
|                |
|                |
|                |
|                |
|                |
|----------------|