................
................
.++++++++++++++.
.++=++++++++=++.
.+=#=++++++=#=+.
.++=+++==+++=++.
.+++++=##=+++++.
.++=+++==+++=++.
.+=#=++++++=#=+.
.++=++++++++=++.
.++++++++++++++.