|----------------|
|                |
|                |
|   #            |
|                |
|                |
|                |
|                |
|                |
|                |
|                |
|                |
|                |
|                |
|----------------|
