|----------------|
|                |
|                |
|                |
|         +      |
|                |
|                |
|                |
|                |
|                |
|                |
|                |
|                |
|                |
|----------------|
