|----------|
|          |
|          |
|   +      |
|          |
|          |
|          |
|          |
|          |
|          |
|          |
|          |
|          |
|          |
|----------|
